ethnic	этникалық
Autonomous	Автономиялы
presidency	президенттік
interdependent	өзара<b/>тәуелді
economically	экономикалық
enormous	алып
industrial	индустриялы
potential	әлует
American	Американдық
revised	жөндеулі
last	ақырғы<b/>рет
Central	Орталық
Asian	Азиялық
governmental	үкіметтік
effective	тиімді
legal	заңды
rigid	қатал
substantial	байыпты
ethnic	этникалық
highly	төтенше
diverse	алуан
considerable	маңызды
topographical	топографиялық
isolated	оңаша
southern	оңтүстік
seasonal	маусымдық
fresh	жаңа
willing	дайын
few	аз
comparable	салыстырмалы
former	бұрынғы


